{"map":[
"##################################",
"#........#.....#...####.##....#..#",
"#.##.##.##.###........#....##.#..#",
"#..####.#....###...##.#.####...###",
"##.####.#..#.#..#####.#.#...##..##",
"##.#########.#........#.#.#....###",
"#..#......#..#.#....##..#.########",
"#.##.######.#####.###..##..#####.#",
"#....#...##.#...#......###.#.....#",
"#.##.#.#.##.#...#######....#.#.#.#",
"##...#.#.#..#.####......####.#.#.#",
"##.###.###.#..#..#.####......#.#.#",
"#......#.#.#.....#.#.#.###.###.###",
"#.######...#.#######.#...#...#..##",
"#........###.####......#..##.#####",
"##.########..#..#.....###..#.....#",
"##..........##.##.....#.##.###.#.#",
"###...#######..##.....#........#.#",
"######....##..###.....############",
"#......##.##.##.###.###.##########",
"#......#..##.##.........####....##",
"#.#....#.#...######.#####........#",
"#...###..#...##...#...........##.#",
"##.####.##.####.#...#.##########.#",
"##.##....#......##########.#.....#",
"##..#....###########...#...#.#.###",
"###.####.....#...###.#.#.#...#..##",
"###.##.##..#...#.....#.#.#########",
"###.##.###..#.###.####.#........##",
"###.##.###..#...#.###...##.####.##",
"###.##...####..######...........##",
"##....##.####.#..####...##########",
"##..#....######..#################",
"##################################"
],
 "items":[
   ["key", 12, 1],
   ["key", 8, 9]
 ],
 "locations":[
   ["closed_door", 3, 9],
   ["closed_door", 5, 3],
   ["closed_door", 7, 3],
   ["closed_door", 9, 3],
   ["stone_stairs_down", 12, 4],
   ["stone_stairs_down", 1, 9]
 ],
 "exits":[
   [["won", 12, 4], 12, 4],
   [["levels/lv2.json", 5, 3], 1, 9]
 ]
}
