{"map":[
        "###############",
        "#.............#",
        "#.............#",
        "#.............#",
        "#.............#",
        "#.............#",
        "#.#...........#",
        "#.#...........#",
        "#.#...........#",
        "#.#...........#",
        "###############"
],
 "items":[
 ],
 "monsters":[
   ["dragon", 10, 6]
 ],
 "locations":[
   ["blue_fountain", 5, 5],
   ["stone_stairs_down", 1, 9]
 ],
 "exits":[
   [["levels/lv1.json", 12, 3], 1, 9]
 ]
}
